4 13 31
###############################
#p    * **    *   3   4       #
# # # #*# # # # # # # # # # # #
#      ** * *  *   6 ** 3 *   #
# # # # # #*# # # # # # #*# # #
#*   * *  4 *b* *   **        #
# # # # # # # # # # # # # #*# #
#    *   7 *        *    **  3#
# #*# # #*#*#*#*# # #1# # #*# #
#        * 4 *2*    *   *     #
#*# # # # # # # # # # #*# # #*#
#x*    * **    **5 **     1   #
###############################