2 13 31
###############################
#p * *2       *  ** 6 *      *#
# # # # #*# # #*# # # # # #*# #
#    * * *** **      *    **  #
# #*# # # # #1# #b#1# # # # #*#
#     4    *     **      *  **#
# # #*# # # # # #*#*#*#*# # # #
#   *     2  *   * *x* *      #
# # # # #*# # # # # # #*# #*# #
#   ****         *1           #
# # # # # # # # # #*# # # # #*#
#  ** *   *    2              #
###############################