1 13 31
###############################
#p     ** * 1 1*   *  * * *   #
# # # #*# # #*#*# # # #*#*#*# #
#   *     *  * *      *   * * #
# # # # # #*# # #*#*# # # # #*#
#f         x **1 *  *  1     1#
# # # # # # # # # #*#1#*# # # #
#*  *      8  *      *        #
# # # # #*# # # #*#*# # # # # #
#*    **  *       *           #
# #*# # # # # # #*# # # # # # #
#           *1  *  *          #
###############################